JBBBBBBBBBBBBBBBBBBBBBBBBBBH        FBBBBBBBBBBBBBBBBBBBBBBBBBBI
A                                                              A
A                                                              A
A                                                              A
A                                                              A
A                                                              A
A                                                              A
A                                                              A
A                                                              A
A                                                              A
A                                                              A
A                                                              A
A                                                              A
A                                                              A
A                                                              A
A                                                              A
A                                                              A
A                                                              A
A                                                              A
G                                                              G








E                                                              E
A                                                              A
A                                                              A
A                                                              A
A                                                              A
A                                                              A
A                                                              A
A                                                              A
A                                                              A
A                                                              A
A                                                              A
A                                                              A
A                                                              A
A                                                              A
A                                                              A
A                                                              A
A                                                              A
A                                                              A
A                                                              A
KBBBBBBBBBBBBBBBBBBBBBBBBBBH        FBBBBBBBBBBBBBBBBBBBBBBBBBBL
